1,,1,1,,1,1,1,1,,,1,,1,1
1,,,,,,,1,,,,,,,1
1,,,,1,1,,1,,,1,,,,1
1,,,,,,,1,,1,1,1,,,1
,,1,1,,,,1,,,1,,,,
1,,,,,,,1,,,,,,,1
1,,,,,,,1,,,,,1,,
,,,1,1,,,1,,,,1,1,1,
1,,,,,,,1,,,,,1,,1
1,,,,,,,,,,1,,,,1
,,,,1,1,,1,,1,1,1,,,
,1,1,,,,,1,,,1,,,,1
,,,,,,,1,,,,,,,1
1,,,,P1,,,1,,,P1,,s,,1
1,,,,,,,1,,,,,,,1
1,,,,,,,1,,,,,,,1
1,1,,1,1,1,1,1,1,1,1,1,,1,1