1,1,,,,,1,1,,,,1,1,1,1,1,1,1,1
1,1,,,,,1,1,1,1,,1,1,1,1,1,,,1
1,1,1,,,,1,,,,,1,1,1,1,1,1,1,1
1,,1,,,,1,1,1,,,,,,1,1,1,1,1
1,1,1,,,,,1,1,1,1,,,,,1,1,1,1
1,1,,,,1,,,,1,1,1,,,,,,,
,,,,,1,,,,,,,,,1,,,,
,,,,,,,,,,,1,1,,,,,,
1,1,,1,1,,,1,,,,1,1,,,1,,1,1
1,1,,1,1,1,,,,,,,1,,,,,1,1
1,1,,,1,1,,,,,,,,,,1,,1,1
1,1,,,,1,,1,1,1,1,,,s,,,,,
1,1,1,,,,,1,1,1,,,,,1,,,1,1
1,,1,,,1,,,,,,,,,,,,1,1
1,1,1,1,,,,,,,,,,,,,1,1,1
1,1,1,1,1,,,,,1,1,,,,,1,1,1,1
1,1,1,1,1,1,,,,,,,,,1,1,1,,1
1,1,1,1,,1,,1,,,1,1,,,1,1,1,1,1
1,1,1,1,1,1,,1,,,1,1,,,1,1,1,1,1