1,1,,,1,1,1,,1,1,1,1
1,c,,c,,,,,,,,1
,,c,,,,,,,1,,
,c,,c,1,1,,,1,1,,1
1,,1,,1,1,,,,,,1
1,,,,,,,,,,,1
,,,,1,,1,1,,,,1
1,,,,1,1,s,1,,,,
1,,,,,,,,,,,
1,,,,,,1,1,,,,1
,,1,1,,,1,1,c,,c,1
1,,1,,,,,,,c,,1
1,,,,,,,,c,,c,1
1,,1,1,,1,,1,,,,1